0 1 2 3 1 2 3 1 2 3 1 2 3 1 2 3 1 2 3 4 27 27 27 27 27 27 27 27 27 27 0 1 2 3 1 2 3 1 2 3 1 2 3 1 2 3 1 2 3 4
20 21 22 23 21 22 23 21 22 23 21 22 23 21 22 21 22 23 24 25 27 27 27 27 27 27 27 27 27 27 21 22 23 24 22 23 24 22 23 24 22 23 24 22 23 24 22 23 24 25
42 43 44 45 43 44 45 43 44 45 43 44 45 43 44 45 43 44 45 51 1 2 3 1 2 3 1 2 3 1 52 43 44 45 43 44 45 43 44 45 43 44 45 43 44 45 43 44 45 46
63 64 65 66 64 65 66 64 65 66 64 65 66 64 65 66 64 65 66 64 65 66 64 65 66 64 65 66 64 65 66 64 65 66 64 65 66 64 65 66 64 65 66 64 65 66 64 65 66 67
42 43 44 45 42 43 44 45 44 45 43 44 45 43 44 45 43 44 45 43 44 45 43 44 45 43 44 45 43 44 45 43 44 45 43 44 45 43 44 45 43 44 45 43 44 45 43 44 45 46
