00 01 02 03 01 02 04 01 03 02 01 03 01 02 03 03 01 02 01 01 02 03 03 02 01 03 01 02 02 01 02 03 01 02 01 03 02 03 01 03 02 01 01 02 03 01 03 03 02 04
21 44 22 23 24 44 25 29 51 24 45 22 43 64 64 64 22 45 64 24 66 24 65 22 66 65 44 45 66 22 44 43 43 43 66 45 64 45 24 22 43 43 44 66 23 24 65 65 24 25
42 66 45 43 23 65 46 29 64 43 66 22 66 24 23 43 66 65 65 22 44 65 24 66 64 24 22 65 43 45 66 64 65 22 64 44 24 45 66 66 65 24 43 44 23 64 24 23 45 67
63 65 64 43 44 45 67 29 23 23 64 64 66 64 66 64 45 22 23 43 65 24 64 23 43 64 66 45 24 43 22 66 45 43 45 43 23 64 24 43 23 45 64 65 24 43 22 65 44 46
21 22 44 65 24 66 25 29 64 43 66 64 44 66 64 43 44 66 65 24 45 64 65 43 65 65 66 43 22 66 66 22 65 64 64 64 65 66 65 43 23 44 44 23 64 22 45 22 22 67
21 45 22 23 43 65 25 29 23 43 66 65 65 22 44 65 24 66 64 24 22 65 43 45 66 64 65 22 64 44 24 45 66 66 65 24 43 44 23 64 24 23 24 45 44 45 23 45 22 46
63 44 22 43 66 64 25 29 22 64 45 66 66 43 64 45 23 65 43 44 65 65 65 22 24 43 23 65 66 22 45 44 23 22 43 23 43 64 24 43 23 64 45 44 64 66 45 23 22 25
89 09 10 10 10 10 89 50 66 23 24 22 65 43 45 44 24 44 44 65 23 44 65 43 64 65 66 64 65 22 45 22 44 64 24 66 22 23 43 43 44 65 66 44 65 43 43 23 64 46
42 65 66 64 64 24 22 22 43 64 64 64 22 45 64 24 66 24 65 22 66 65 44 45 66 22 44 43 43 43 66 45 64 45 24 22 43 43 44 66 23 24 65 65 24 24 22 66 43 25
42 45 23 45 45 24 65 66 66 43 24 24 65 44 64 43 23 66 66 66 22 23 66 64 44 45 45 66 65 23 43 24 65 66 43 24 24 66 45 64 45 66 45 23 22 24 66 24 65 67
63 64 43 66 22 66 24 23 43 66 65 65 22 44 65 24 66 64 24 22 65 43 45 66 64 65 22 64 44 24 45 66 66 65 24 43 44 23 64 24 23 24 45 44 45 23 45 22 24 25
21 23 66 45 64 43 66 64 44 66 64 43 44 66 65 24 45 64 65 43 65 65 66 43 22 66 66 22 65 64 64 64 65 66 65 43 23 44 44 23 64 22 45 22 22 43 24 64 23 67
63 66 65 23 65 64 23 45 22 65 65 64 22 23 65 45 23 22 65 65 66 44 66 23 45 64 23 66 64 44 65 44 64 23 64 24 66 22 65 44 23 23 45 64 43 65 65 43 66 46
42 65 22 23 43 64 45 65 23 23 64 64 66 64 66 64 45 22 23 43 65 24 64 23 43 64 66 45 24 43 22 66 45 43 45 43 23 64 24 43 23 45 64 65 24 43 22 65 44 25
21 65 23 65 43 22 22 44 44 45 64 45 44 66 44 66 65 24 44 24 66 24 66 23 24 23 22 24 66 43 23 23 22 45 43 43 65 64 64 44 64 45 23 65 45 64 45 22 43 46
42 23 24 22 66 66 44 24 24 23 66 66 24 22 23 43 22 44 45 45 45 65 66 44 64 24 65 22 64 64 45 23 22 24 64 65 64 23 43 43 24 44 44 44 24 24 45 24 64 67
63 23 44 64 22 44 65 22 45 45 22 64 65 24 64 45 24 64 22 45 45 65 24 45 45 45 65 64 24 65 64 44 43 44 43 64 43 22 66 45 65 43 23 45 45 45 23 44 44 25
21 45 65 23 64 24 23 22 23 65 44 22 43 24 22 44 66 66 64 45 24 22 22 45 45 65 44 64 22 24 23 45 45 22 65 43 44 23 43 22 22 23 65 24 64 23 43 44 43 25
63 44 64 45 23 65 23 44 22 64 24 22 64 44 64 44 24 65 45 24 23 65 44 43 44 44 23 45 22 22 43 64 24 66 23 43 22 66 24 66 45 64 24 23 24 24 22 64 66 46
21 45 64 23 44 45 23 65 66 23 24 22 65 43 45 44 24 44 44 65 23 44 65 43 64 65 66 64 65 22 45 22 44 64 24 66 22 23 43 43 44 65 66 44 65 43 43 23 64 46
63 66 65 22 23 43 22 66 43 44 24 64 64 22 24 45 66 24 22 45 22 66 23 43 44 64 45 65 66 45 23 22 65 44 43 65 43 66 66 24 64 43 45 44 43 64 65 64 45 25
21 65 45 44 22 24 22 65 43 43 44 44 64 23 45 23 64 65 65 45 64 22 23 24 44 23 64 22 22 44 45 45 23 43 66 22 43 66 43 24 43 45 44 65 65 44 45 43 66 67
42 65 22 23 43 64 45 65 23 23 64 64 66 64 66 64 45 22 23 43 65 24 64 23 43 64 66 45 24 43 22 66 45 43 45 43 23 64 24 43 23 45 64 65 24 43 22 65 44 25
42 44 66 64 43 43 64 43 66 45 45 43 44 22 65 44 44 22 43 43 24 22 43 66 44 65 24 44 44 23 24 22 65 23 66 45 22 66 22 66 22 43 24 66 44 22 44 23 23 46
21 23 66 45 64 43 66 64 44 66 64 43 44 66 65 24 45 64 65 43 65 65 66 43 22 66 66 22 65 64 64 64 65 66 65 43 23 44 44 23 64 22 45 22 22 43 24 64 23 67
42 65 22 23 43 64 45 65 23 23 64 64 66 64 66 64 45 22 23 43 65 24 64 23 43 64 66 45 24 43 22 66 45 43 45 43 23 64 24 43 23 45 64 65 24 43 22 65 44 25
21 44 45 66 65 22 23 22 45 65 44 23 24 23 66 22 24 24 43 64 43 65 44 23 22 64 23 43 43 23 64 66 44 45 43 44 45 44 45 22 22 64 43 22 23 23 66 22 43 67
63 22 66 43 24 23 64 64 23 22 45 22 22 24 23 24 22 45 65 45 66 65 64 64 66 43 64 66 65 65 24 43 23 24 43 66 23 43 43 65 64 44 23 23 65 64 65 65 45 67
21 65 45 44 22 24 22 65 43 43 44 44 64 23 45 23 64 65 65 45 64 22 23 24 44 23 64 22 22 44 45 45 23 43 66 22 43 66 43 24 43 45 44 65 65 44 45 43 66 67
63 23 44 64 22 44 65 22 45 45 22 64 65 24 64 45 24 64 22 45 45 65 24 45 45 45 65 64 24 65 64 44 43 44 43 64 43 22 66 45 65 43 23 45 45 45 23 44 44 25
63 23 45 44 66 44 45 45 44 22 23 23 44 22 45 22 66 24 45 22 24 45 64 66 44 43 45 22 22 65 24 45 22 65 44 64 23 66 66 64 45 64 65 23 45 65 66 64 44 46
63 22 66 43 24 23 64 64 23 22 45 22 22 24 23 24 22 45 65 45 66 65 64 64 66 43 64 66 65 65 24 43 23 24 43 66 23 43 43 65 64 44 23 23 65 64 65 65 45 67
42 45 23 45 45 24 65 66 66 43 24 24 65 44 64 43 23 66 66 66 22 23 66 64 44 45 45 66 65 23 43 24 65 66 43 24 24 66 45 64 45 66 45 23 22 24 66 24 65 67
63 66 65 23 65 64 23 45 22 65 65 64 22 23 65 45 23 22 65 65 66 44 66 23 45 64 23 66 64 44 65 44 64 23 64 24 66 22 65 44 23 23 45 64 43 65 65 43 66 46
42 65 22 23 43 64 45 65 23 23 64 64 66 64 66 64 45 22 23 43 65 24 64 23 43 64 66 45 24 43 22 66 45 43 45 43 23 64 24 43 23 45 64 65 24 43 22 65 44 25
21 65 23 65 43 22 22 44 44 45 64 45 44 66 44 66 65 24 44 24 66 24 66 23 24 23 22 24 66 43 23 23 22 45 43 43 65 64 64 44 64 45 23 65 45 64 45 22 43 46
42 23 24 22 66 66 44 24 24 23 66 66 24 22 23 43 22 44 45 45 45 65 66 44 64 24 65 22 64 64 45 23 22 24 64 65 64 23 43 43 24 44 44 44 24 24 45 24 64 67
42 44 66 64 43 43 64 43 66 45 45 43 44 22 65 44 44 22 43 43 24 22 43 66 44 65 24 44 44 23 24 22 65 23 66 45 22 66 22 66 22 43 24 66 44 22 44 23 23 46
21 45 23 22 64 22 43 24 45 23 22 64 65 24 45 22 45 24 23 24 24 66 22 43 65 44 43 44 24 43 43 43 66 66 22 64 65 24 45 45 23 44 66 45 66 66 45 44 23 25
42 66 23 43 64 24 64 44 45 64 64 64 43 22 22 23 43 24 24 66 45 65 45 64 45 24 45 24 23 64 23 64 65 44 45 43 23 22 65 66 66 66 64 45 64 23 44 24 24 46
63 23 44 64 22 44 65 22 45 45 22 64 65 24 64 45 24 64 22 45 45 65 24 45 45 45 65 64 24 65 64 44 43 44 43 64 43 22 66 45 65 43 23 45 45 45 23 44 44 25
63 45 44 64 24 23 65 44 64 45 44 66 64 45 45 64 24 65 45 65 44 64 64 44 45 22 23 22 66 24 23 24 64 24 44 44 66 66 45 24 44 65 22 43 24 64 66 22 24 46
21 24 65 66 22 44 44 45 44 65 23 43 23 43 44 45 44 64 22 22 65 22 44 23 64 44 23 45 43 22 22 22 66 65 65 23 23 22 66 44 43 23 24 64 22 65 22 43 24 67
21 44 45 66 65 22 23 22 45 65 44 23 24 23 66 22 24 24 43 64 43 65 44 23 22 64 23 43 43 23 64 66 44 45 43 44 45 44 45 22 22 64 43 22 23 23 66 22 43 67
63 66 65 22 23 43 22 66 43 44 24 64 64 22 24 45 66 24 22 45 22 66 23 43 44 64 45 65 66 45 23 22 65 44 43 65 43 66 66 24 64 43 45 44 43 64 65 64 45 25
42 23 24 22 66 66 44 24 24 23 66 66 24 22 23 43 22 44 45 45 45 65 66 44 64 24 65 22 64 64 45 23 22 24 64 65 64 23 43 43 24 44 44 44 24 24 45 24 64 67
63 23 44 64 22 44 65 22 45 45 22 64 65 24 64 45 24 64 22 45 45 65 24 45 45 45 65 64 24 65 64 44 43 44 43 64 43 22 66 45 65 43 23 45 45 45 23 44 44 25
21 45 65 23 64 24 23 22 23 65 44 22 43 24 22 44 66 66 64 45 24 22 22 45 45 65 44 64 22 24 23 45 45 22 65 43 44 23 43 22 22 23 65 24 64 23 43 44 43 25
63 44 64 45 23 65 23 44 22 64 24 22 64 44 64 44 24 65 45 24 23 65 44 43 44 44 23 45 22 22 43 64 24 66 23 43 22 66 24 66 45 64 24 23 24 24 22 64 66 46
84 85 86 87 85 87 86 85 85 87 87 86 85 87 85 86 86 85 87 86 87 86 85 86 85 85 87 86 85 86 87 85 86 85 85 87 86 87 85 86 85 85 86 87 85 87 85 86 85 88