0 3 3 3 3 3 3 3 3 3 3 3 3 3 3 3 3 3 3 4
21 22 23 24 45 66 23 64 65 66 24 45 66 22 64 24 65 22 23 25
21 43 44 45 23 64 66 22 43 23 44 66 24 65 23 64 66 43 23 25
21 64 65 66 43 44 45 44 22 24 66 43 23 45 44 22 66 44 64 25
21 22 22 64 66 22 43 22 23 45 44 23 44 66 24 65 22 64 45 25
21 66 43 23 45 44 22 23 24 44 45 44 22 24 66 43 23 45 22 25
21 23 44 66 24 65 66 24 65 23 64 22 43 44 23 44 66 24 65 25
21 22 23 24 45 66 23 64 65 66 24 45 66 22 64 24 65 22 23 25
21 43 44 45 23 64 66 22 43 23 44 66 24 65 23 64 66 43 23 25
21 64 65 66 43 44 45 44 22 24 66 43 23 45 44 22 66 44 64 25
84 85 85 85 85 85 85 85 85 85 85 85 85 85 85 85 85 85 85 88
0 3 3 3 3 3 3 3 3 3 3 3 3 3 3 3 3 3 3 4
